 0 0 0 0 0 0 0 0 0 0 0 0 0 0 0 0 0 0 0 0 0 0 0 0 0 0 0 0 0 0 0 0 0 0 0 0 0 0 0 0 0 0 0 0 0 0 0 0 0 0
 0 0 0 0 0 0 0 0 0 0 0 0 0 0 0 0 0 0 0 0 0 0 0 0 0 0 0 5 0 0 0 0 0 0 0 0 0 0 0 0 0 0 0 0 0 0 0 0 10 0
 0 0 0 0 0 0 0 0 0 0 6 5 0 0 5 0 0 0 0 0 0 0 0 0 0 8 0 43 0 7 0 0 0 0 0 0 5 0 0 0 0 0 0 0 0 0 0 5 43 0
 0 0 0 0 0 0 0 0 7 0 44 0 0 0 43 0 5 0 0 0 0 0 0 5 0 44 0 0 0 44 0 7 0 8 0 0 43 0 5 0 0 0 0 0 0 7 0 43 0 0
 0 0 0 0 0 0 43 0 44 0 0 0 0 0 0 0 43 0 0 0 0 0 0 43 0 0 0 0 0 0 0 0 0 44 0 0 0 0 44 0 0 0 0 0 0 44 0 0 0 0
 0 0 0 6 5 0 0 0 0 0 0 0 8 0 7 0 0 6 5 7 0 5 0 8 0 0 5 0 6 0 0 8 0 0 5 0 6 0 0 0 7 5 0 6 8 0 6 0 0 0
 43 42 43 42 43 42 43 42 43 42 43 42 43 42 43 42 43 42 43 42 43 42 43 42 43 42 43 42 43 42 42 42 42 42 42 42 42 42 42 42 42 42 42 42 42 42 42 42 42 42 
 0 0 0 0 0 0 0 0 0 0 0 0 0 0 0 0 0 0 0 0 0 0 0 0 0 0 0 0 0 0 0 0 0 0 0 0 0 0 0 0 0 0 0 0 0 0 0 0 0 0
 0 0 0 0 0 0 0 0 0 0 0 0 0 0 0 0 0 0 0 0 0 0 0 0 0 0 0 0 0 0 0 0 0 0 0 0 0 0 0 0 0 0 0 0 0 0 0 0 0 0
 
